{
    "date": "29-03-2020 10:00",
    "confirmed": {
        "1": {"c": 22, "d": 0, "r": 0},
        "2": {"c": 2, "d": 0, "r": 0},
        "3": {"c": 6, "d": 0, "r": 0},
        "4": {"c": 2, "d": 0, "r": 0},
        "5": {"c": 5, "d": 1, "r": 0},
        "6": {"c": 1, "d": 0, "r": 0},
        "7": {"c": 11, "d": 0, "r": 0},
        "8": {"c": 41, "d": 3, "r": 0},
        "9": {"c": 45, "d": 0, "r": 0},
        "10": {"c": 4, "d": 0, "r": 0},
        "11": {"c": 2, "d": 0, "r": 0},
        "12": {"c": 5, "d": 0, "r": 0},
        "14": {"c": 8, "d": 0, "r": 0},
        "15": {"c": 1, "d": 0, "r": 0},
        "16": {"c": 9, "d": 2, "r": 0},
        "17": {"c": 6, "d": 1, "r": 0},
        "18": {"c": 57, "d": 1, "r": 0},
        "19": {"c": 1, "d": 0, "r": 0},
        "20": {"c": 1, "d": 0, "r": 0},
        "21": {"c": 1, "d": 0, "r": 0},
        "22": {"c": 46, "d": 0, "r": 0},
        "23": {"c": 59, "d": 1, "r": 5},
        "24": {"c": 1, "d": 0, "r": 0},
        "25": {"c": 82, "d": 0, "r": 0}
    }
}
